Rad	Radiology
Preor	Preor
Or	Or
Recovery	Recovery
Lab	Lab
Pulmonary Lab	Pulmonary Lab
Vascular Lab	Vascular Lab
Linen	Linen
Mat Mgnt	Mat Mgnt
Pre Admit Scrn	Center for Preoperative Evaluation
Cardiology Rehab	Cardiology Rehab
Blood Draw	Blood Draw
Auditorium	Auditorium
Special Test	Special Test
Endoscopy	GI Endoscopy
Ed	Ed
Emt	Emt
Admit	Admit
Patient Center	Patient Center
Mri/Ct	Mri/Ct
